#########
#P      #
####### #
#    G# #
# ##### #
#       #
# # # # #
# #   # #
#########