#########
#P      #
####### #
#     # #
# ##### #
#       #
# # # # #
# #   #G#
#########